111111111111
1P.........1
1G11.1111..1
1..........1
1..111111111
1..........1
111111111..1
1..........1
1..........1
111111111111