111111111111
1P.R.......1
1D11.1111..1
1.......L..1
1..111111111
1R.........1
111111111..1
1..........1
1......U..G1
111111111111