111111111111
1P.........1
111111111..1
1..........1
1..111111111
1..........1
111111111..1
1..........1
1.........G1
111111111111