111111111111
1P...D.....1
1..........1
1U.........1
1..........1
1R........D1
1..........1
1..........1
1.........G1
111111111111