111111111111
1P..D......1
1.1........1
1D.1.R.....1
1...1.....D1
1R...1.....1
1...D.1...11
1...R..1...1
1.........G1
111111111111