111111111111
1PR..D.1...1
1D.........1
1..........1
1..........1
1..........1
1.....D....1
1R...1.....1
1...R.R...G1
111111111111