111111111111
1P...R..D..1
1....1.....1
111D.......1
1..........1
1....1..R..1
1..R..D.1.11
1...R.L1...1
1...1.R...G1
111111111111