111111111111
1P...R.D.D.1
1....11.1..1
111.D1...1D1
1..1..1.1..1
1....1.1R..1
1..R..D.1.11
1.D..L.1.1.1
1...1.LR..G1
111111111111